001111111111110000
000111111111100000
000011111111000000
000011111111000000
000011111110000000
000011111100000000
000011111000000000
000001100000000000
000000000000000000
000000000000000000
