0000000000000000000000000000
0000000000000000000000000000
0000101000000000000000000000
0000111000000000000000000000
0000111111100000000000000000
0011111111000000000000000000
0010111100000000000001101110
0000000001100000000001111111
0000010111100001000001111100
0000110011111000000001101000
0011111111111110001111111111
0000111111111111111111111111
0000010111111110010101111111
0000010111111110011001100000
0000000011111110000000000000
0000000011111100000010000000
0000000001110000000000000000
0000000000010000000000000000
0000000011010000000000000000
1111111111110000000000000000
1111111111100000000000000000
1111111111110000000000001000
1111111111110000000011111110
1111111111100000000011111110
1111111111100000000011111110
1111111111000000000010111110
0111111111000000000000101110
0111111111100000000000111110
0110111111000000000000100110
0001001110000000000000000000
0000000000000000000000000000
0000000000000000000000000000
0000000000000000000000000000
0000000000000000000000000000
0001011100000000000001100000
0111111111100000000000000000
0000001100000000000000000000
0000000000000000000000000000
0000000000000000000001000000
0000000000000000000000000000
0000000000000000000000110000
0000000000000000011111111100
0001111111100000111011110000
0001111111101111111011100100
0101111111111111111111110000
0000111111111111111111010000
0101111111111111111110110000
0101111111111111111011110000
0000111111111111111111110000
0000011111111111111100000000
0000111111111111111100000000
0000111111111111111100000000
0000011111111111111100000000
0000011111111111111100000000
0000111111111111111100000000
0011111111111111101000000000
0011111111111111011100000000
0000111111111111111110000000
0000011111111111111111100000
0010011111111111111100000000
0000011111111111111100000000
0000011111111111111111100000
0000011111111111111111100000
0000000011111111111111100000
0000000001101110111000000000
0000010010101110000000000000
0000000011001010000000000000
0000000001001110000000000000
0000010000000000000000000000
0000000000000000000000000000
0000011111101110000000000000
0000111111101100000000000000
0000111111100110000000000000
0000111111100000000000000000
0000111111111110000000000000
0000111110000000000000000000
0000000000000000000000000000
0000111000000000000000000000
0000110100000000000000000000
0000111110000000000000000000
0000111111000001000000000000
0001111111011011000111110100
0000111111101111000111111100
0000010000000011000111111110
0000111000000111000111111110
0000010000111111000111111100
0000111110110011000111111100
0000111000000011000111111110
0000111110111111000111101000
0000001000000011010111110000
0000011000000001010011111100
0000011000000001010111111000
0000010000000000000111111110
0000111000000000001111111110
0000011010000000000011100000
0000000000000000000111110000
0000000000000001000011000000
0000000000000000000000000000
0000000000000000000000000000
0000000000000000000000000000
