000000000000000000
000000000000000000
000000000000000111
000000000000001111
000000001111111111
000000001111111110
000000001111111110
100000000111111100
110000000011111000
110000000001111000
110000000000111100
110000000000111110
000000000000111111
000000000000111111
000000000000111100
000000000000000000
000000000000000000
000000000000000000
000000000000000000
000000011000000000
000011111000000000
000011111000000000
000011110000000000
000000100000000000
000000000000000000
000000000000000000
000000000000000000
000000000001100000
000000000111111000
000000000111111100
001111100011111000
011111100000000000
011111100000000000
001111100000000000
000011100000000000
000001110000000001
000001111000000001
000001111000000001
000001111100000001
000011111100000011
011111111100000011
111111111100000111
111111111100000111
111111111100000011
111111111100000000
111111111000000000
111111100000000000
111000000000000000
110000000000000000
110000000000000000
100000000000000000
000000000000000000
000000000000000000
000000000000000001
011100000000000011
111100000000000011
111100000000000011
111100000000000011
111000000000000001
010000000000000000
000000000000000000
000000000000000000
000000000000000000
011000000000001100
111100000000001110
111100000000011110
111100000000011110
000000000000011110
000000000000001100
000000000000000000
000000000000000000
000000000011100000
000000000111100000
000000000111100000
000000000111100000
110000000001100000
111000000000000000
111000000000000000
111000000000000000
000000000000000000
000000000000000000
000000000000011000
000111100000111100
000111110000111100
001111100000111100
011111000000011100
111110000000011100
111000000000000000
110000000000000000
110000000000000000
100000000000000000
100000000000000000
000000000000000000
000111100000000001
000111110000000011
000011110000000111
000001110000001111
000000000000001111
000000000000011100
000000000000111000
000000000001111000
000000000011111000
000000000001111000
000000000000111100
000000000000011000
000000000000000000
000000000000000000
000000000000000000
000000000000000000
110000000000000000
111000000000000000
111111000000000000
111111100000000000
111111110000000000
011111110000000000
111111110000000000
111111100000000000
111111100000000000
111111000000000000
111110000000000000
111100000000000000
111100000000000000
111100000000000000
111110000000000000
111110000000000001
011110000000000011
011110000000000011
001100000000000011
001100000000011001
000000000001111000
000000000011111000
000000000111110000
011000000111100000
111000000011000000
111000000000000000
110000000000000000
110000000000000000
000000000000000000
000000000000000000
000000000000000000
000000000000000000
000000000000000000
000000000000000000
000000000000000000
000000000000000000
000000000001111000
001110000111110000
011111000111110000
011110000111100000
111110000111000000
111000000111000000
110000000111000000
000000000111000000
000000000111000000
000000000111100000
000000000111100000
000000000011110000
000000000011111111
000000000001111111
000000000000111111
000001100000011111
000011111000000000
000011111000000000
000011111000000000
000000010000000000
000000000000000000
000000000000000000
000000000000000000
000000000000000000
000000000000000000
000000000000000000
000000000000000000
000000001110000000
000000001111000000
000000011111100000
000000011111100000
000111001111100000
011111000000000000
011111000000000000
011110000000000000
000000000000000000
000000000000000000
000000000000110000
000000000001111000
000000000001111000
000000000001111000
000000000001111100
000000000000100011
100000000000000001
111110000000000000
111111100000000000
011111100000000000
001111100000000000
000111000000000000
000111000000000000
000010000000000000
000000000000000000
000000000000000000
000000000000000000
000000000001110000
000000000011110000
000000000011110000
000000000001110000
111000000001100000
111000000000000000
111100000000000000
111100000000000000
011100000000000000
011000000000000000
000000001110000000
000000011110000000
000000011110000000
000000001110000000
100000001110000000
100000000100000000
000000000000000000
000000000000000000
000000000000000000
000000000000000000
000000000000000000
000000000000000000
000000000000000000
000000100000000000
000001111000000000
000001111100000000
000001111100000000
000001111110000111
000001111100000111
000001111100000011
000011111000000000
000111110000000000
001111100000000000
000110000000000000
000000000000000000
100000000000000000
100000000000000000
100000000000000000
110000000000000000
110000000000000011
111000000000000011
111100000000000111
111100000000000111
111000000000000111
110000000000000111
100000000000000010
000000000000000000
000000000000000000
000000000000000000
000000000000000000
100000000000000001
