000000001111110000
000000001111110000
111000001111100000
111000001111100000
111000000111100000
110000000111100000
110000000111111001
100000000111111111
100000000011111111
100000000011100001
000000000000000000
000000000000000000
000000000000000000
000000000000000000
000000000000000000
000000000001110000
000000000011111000
000000000011111100
000000001111111100
000000111111111100
000001111111111110
000011111100111111
000011111000011111
000011100000011111
000001000000011111
000000000000001111
000001000000000111
000011100000000010
000011100000000000
000011100000000000
000011110000000000
000011110000000000
000011111000000000
000011111100000000
000011111100000000
011111111100000001
111111111000000001
111111111000000001
011111110000000000
011111100000000000
011110000000000000
001100000000000000
000000000000000000
000000000000001100
000000000000011110
000000000000011110
000000000000001110
000110000000001110
000111100000001111
000111110000001111
