000111110000000000
000000000000000000
000000000000000000
000000000000000000
000000000000000100
000000000000001110
000000000000001111
000000000000001111
000000000000000111
000001110000000001
000011111100000000
000001111100000000
000000111000000000
000000000000000000
000000000000000000
000000000000000000
000000000000000001
000000000000000011
000000011100000111
000000111100000111
000000111100000111
000001111000000111
000001110000000011
000000000000000111
000000000000000111
000000000000001111
000001000000001111
000011000000001111
000011100000001111
000011100000000100
000011100000000000
000011100000000000
000000000000000000
000000000001110000
000000000001110000
000000000001111000
000000000001111000
000000000000111000
000000000000010000
000000000000000000
000000000000000000
000000000000000000
000000000000000000
000000111100000000
000000111110000000
000000111110000000
000000001110000000
000000000000000000
000000000000000000
000000000000000000
000000000000000011
000000000000000111
000000000000000111
111000000000000111
111110000000000011
111110000000000001
111100000000000000
111100000000000000
111000000000000000
100000000000000000
000000000000000000
000000000001111001
000000000001111111
000000000001111111
000000000000011111
000000000000000000
000000000000000000
000000000000000000
000000000000000000
000000000000000000
111100000000000000
111100000000000000
111100000000000000
111000000000000000
111000000000111111
111000000001111111
111000000001111111
111000000011111111
000000000011111111
000000000011111111
000000000001111111
000000000000111111
000000000000001111
000000000000000000
000000000000000000
000000000000000000
000000000000000000
000111000000000000
000111110000000000
000111111000000000
000111111111100000
000111111111110000
001111111111110000
011111111111110000
011111000111100000
111110000011000000
110000000000000000
000000000000000000
000000000000000000
000000000001000000
