0000000000000000000000000000
0000000000000000001100000000
0000000001011100001100000000
0000000001010000011111010000
0000000001111111011111111000
0000000001111111111111000000
0000000001111111111110000000
0000000111111101011100000000
0000001001111000011110000000
0000000001110000001110000000
0000000000000000000100000000
0000101101110000000000000000
0000000001000000000000000000
0000000000111000001100000000
0000000000111100001100000000
0000000000111101111101000000
0000000000011000000000000000
0000000000011000000000000000
0000000000001101101100000000
0000000000001111011110000000
0000000000000011111110000000
0000000000000000101000000000
0000000000000000000000000000
0000000000000000101000000000
0000000000000000000100000000
0000000000000000101100000000
0000000000000000101010000000
0000000000000000000000000000
0000000000000000000000000000
0000000000000000000000000000
0000000000000000000000000000
0000000000000000000000000000
0000000000000000110000000000
0000000000000000111000000000
0000000000000000110000000000
0000000000000000010000000000
0000001000000100111000000000
0000000000111111111000000000
0000011000111111111000000000
0000011101111111111000000000
0000011001111111110000000000
0000001001111111111000000000
0000111111111111110000000000
0001111111111111111000000000
0000111111111111111000100000
0001111111111111111111110000
0000111111111111111111111000
0000111111111111111111111100
0000001111111111111111111000
0000001111111111111111111000
0000001100000111111111111100
0000000000000011111111111000
0000000000000000011111100000
0000000000000011010111100000
0000000000000001011111100000
0000000000000000010111000000
0000000000000000001010000000
0000000000000000000000000000
0000000000000000000000000000
0000000000000000001000000000
0000000000000000000000000000
0000000000000000000000000000
0000000000000000000000000000
0000000000000000000000000000
0000000000000000000000000000
0000000000000000000000000000
0000000000000000000000000000
0000000000000000000010000000
0000000000000000000100000000
0000000000000000000000000000
0000000000000000000010100000
0000110001000000001111000000
0000000000000000000111000000
0000000000000000011110000000
0000001111000010111111101000
0000000011000000001111111000
0000101011101100011111111000
0000000011000000000011100000
0000000011100000111111101000
0000000011000000011111111000
0000000001000000011111111000
0000000001000000011111100000
0000000000000000011111101000
0000000011100000111111100000
0000000011100000111110100000
0000000011000000111111100000
0000000011000000011011100000
0000000001000000000010100000
0000000000000000000011100000
0000000001000000000001100000
0000000001000000000000000000
0000000000000000000000000000
0000000000000000000000000000
0000000000000000000000000000
0000000000000000000000000000
0000000000000000000000000000
0000000000000000000000000000
0000000000000000000000000000
0000000000000000000000000000
0000000000000000000000000000
