000100000000000000
000000000000000000
000000000000000000
000000000000000000
000000000000000100
000000000000001110
000000000000001111
000000000000001111
000000000000001111
000000111000001111
000001111111001110
000001111111111000
000001111111111000
000001111111111000
000000111111111000
000000111111111000
000000111111110000
000000111111110000
000000011111100000
000000011111000000
000000001110000000
000000000000110000
000000000000111110
000000000000111111
000000000000011111
000000000000001111
000000000000000111
000000000000000000
000000000000000000
000000000000000000
111000000000000000
111100000000000000
111100000000000000
111100000000000000
000000000000000000
000000000000000000
000000000000000000
000000000000000000
000000000111100000
000000001111110000
000000011111100000
000000011111000000
000000111111000000
000001111110000000
000011111100000000
000011111100000000
000000000000000000
000000000000000000
000000000000000000
000000000000000000
