000000000111111110
000000000111111111
000000000111111111
000000000011111111
000000000001111111
000000000011111110
000000000011111110
000000000111111100
000000000111111000
000000000111110000
000000000111110000
000000000011000011
100000000000000011
111000000000000011
111110000000000011
111111000000000001
111110000000000000
111110000000000000
011100000000000000
001000000000000000
000000000000000000
000000000000000000
000000000001111000
000000000011111100
000000000011111000
000000000000000000
000000000000000000
000000000000000000
000000000000000000
000000000000000000
001111000000000000
011111000000000001
111111000000000011
111110000000011111
111100000000111111
111100000001111111
111000000001111111
111000000000111111
111000000000111111
000000000000111111
000000000000000011
000000000000000001
000000000000000001
000000000000000000
000000000110000000
000000000111000000
000000001111000000
000000000111000000
000000000111000000
000000000111000000
