000001111110000000
000000011110000000
000000000000000000
000000000000000000
000000000000000000
000000000000000000
000011000000000111
000011100000000111
000111100000000111
000111100000000001
000011110000000000
000011110000000000
000001110000000000
000000000000000000
000000011000000000
000000011111000000
000000011111111000
000000111111111100
000000111111111110
000000011111111110
000000011100011110
000000000000000100
000000000000000000
000000000000000000
000000000000000110
000000000000001110
000000000000001111
000000000000001111
000000000000001111
000000000000001111
111000000000000111
111100000000000111
111111110000000011
111111111100000011
110011111100000011
000001111100000011
000001111000000001
000000111000000001
000000010000000001
000000000000000001
000000000000000011
000000000000000111
000000000000001111
000000000000001111
000000000000000000
000000000011000000
000000000111100000
000000000111100000
000000001111100000
000000001111100000
000000001111111000
000000000111111111
000000000000011111
000000000000001111
000000000000000001
000000000000000000
000000000000000000
000000011000000000
000000111000000000
000001111000000000
000011111000000000
000011110000000000
000001100000000000
000000000000000000
100000000000000000
100000000000000000
100000000110000000
100000000111100000
100000000111110000
000000000111111000
000000000001111100
000000000000011110
000000000000011111
000000000000011111
000000000000111111
100000000001111111
100000000001111111
000000000011111000
000000000011110000
000000000011000000
000000000000000000
000000000000000000
000011111000000000
000011111000000000
000111110000000000
000111100000000001
000000000000000001
110000000000000001
110000000000000000
100000000000000000
100000000000000000
000000000000000000
000000000000000000
000000000000000000
000000000000000000
000000000000000100
000000111000111111
000001111101111111
000011111001111111
000011110000111111
