00000000000000000000111000000000000000000000000011
00000000111000000000000000000000000000000000000000
00000000000000000000000000000000000000000000000000
11100000000000001110111000000000000000001110000000
00000000000000000000000000000000000000000000000000
00000000111000000000000000000000000000000000000000
00000000000000000000111000000000000000000000000000
00000000000000000000000000000000000000001110000011
00000000000000001110000000000000000000001110000000
11100000000000001110000000000000000000000000000011
00000000000000000000000000000000111011100000000000
11100000111000001110000000000000111000000000000000
00001110000000001110000000001110000000000000000000
00000000111000000000000000000000000000000000000000
00000000000000000000000000000000000000001110000000
00001110000011100000000000000000000000001110111000
00001110000000000000111000000000000000000000000000
00000000000011100000000000000000000000000000000000
00000000111000000000000000000000000011100000000000
00000000000000000000000011100000000000000000000011
11100000000011100000000000000000111000000000111000
00000000000000000000000000000000000000000000111000
00000000000000000000000000000000000000000000111000
00000000000000000000000011100000000000000000000000
00000000000000000000000000001110111000001110000000
11100000000000000000000000000000000011100000000000
00000000000000000000000000000000000000000000000000
00000000000011101110000000000000000000000000000000
00000000000000000000000000000000000000000000000000
00000000111000001110000011100000000000000000000000
00001110000000000000000000001110000011101110111000
00000000000000000000000000000000000000001110000000
00000000000000000000000000000000000000000000000000
00000000000000000000000000000000000000000000000000
00000000000000000000000000001110000000001110000000
00000000111000000000000011100000000000000000000000
11100000111000000000000000000000000000001110000011
00001110111000000000000000000000000011100000000000
11100000111000000000111000000000000000001110000000
00000000000000000000111000000000000000000000000011
00000000111000000000000000001110111000000000111000
00000000000011100000111000000000000000001110000000
00000000000000000000111011100000000000000000000000
00000000000011100000000000000000000000000000000011
11100000111000000000000000000000000011100000111000
11101110000000000000000011100000000011101110111000
00000000000000000000000011100000000000000000000000
00000000111000000000000000000000000000000000000000
00000000000000000000000000000000000000000000000000
00000000000011100000000011101110111000000000000000
