000000000000000000
000000000000000000
000000000000000000
000000000000000000
000000000000000000
000000000000000000
000000000000000000
111111000000000000
111111100000000000
111111110000000000
111111110000000000
111111111000000000
011111111000000000
001111111000000001
001111111000000001
001111111000000001
000111111000000001
000001110000000001
000000000000000000
000000000000000000
000000000000000000
000000000000000000
000000000001111111
000000000001111111
000000000001111111
000000000000000001
000011100000000000
000011100000000000
000011100000000000
000011100000000000
000011100000000000
000001100000000000
000000000000000000
000000000011110000
000000000011110000
000000000001111000
000000000001111000
000000000000111000
000000000000000000
000000000000000000
000000000000000000
000000000000000000
100000000000000000
100000000000000000
111111000000000000
011111000000000000
001111000000000000
001111000000000000
000111000000000000
000111000000000000
000000000000000000
000000000000000000
000000000000000000
000000000000000000
000000000000000000
000000000000000001
000000000000000111
000000000000001111
000000000000001111
011110000000000111
011111000000000001
011111100000000000
011111110000000000
111111111000000000
111100011100000000
111000011110000000
110000011110000000
100000001111000000
000000001111000000
000000000000000000
000000000000000011
000000000000000111
000000000000000111
000000000000000111
000000000000000111
000000000000000110
000000000000000000
000000000111111100
000000001111111110
000000001111111111
000000000111111111
000000000001111111
000000000000111110
000000000000011100
000000000000000000
000000000000000000
000000000000000000
000000001110000000
000000111111000000
000001111111111000
000001111111111100
000000111111111110
000000011111111110
000000000000000000
000000000000000000
000000110000000000
000001111000000000
000001111000000000
000001111000000000
000011111000000000
