000000000000000000
011100000000000000
111111000000000000
111111110000000000
111111111110000000
111111111111000000
111000111111000000
110000000000000011
110000000000000011
110000000000000011
110000000000000000
110000000000000000
000000000000000000
000000000000000000
000000000000000000
000000000000000001
000000000000000001
000000000000000001
000000000000000011
100000000000000001
111111100000000000
111111110000000000
000111110000000000
000000000000000000
000000000000000000
000000000000000000
000000000000000000
000000000000001000
000000000001111100
000000000011111100
001110000111111100
111111100111111000
111111100111110000
111110000111110000
111000000111110000
000000000011110000
000000000000110000
000000000000000000
000000000000000000
000000000000000000
000000000000000000
000000000000000000
000000000000001100
000000111100111110
000001111111111110
000001111111111110
000000000000111110
000000000000011110
000000000000000100
100000000000000000
100000000000000000
110000000000000001
110000000000000011
110000000000000011
110000000000000011
111000000000000011
111000000000000001
111000000000000001
111100000000000001
111100000000000000
111000000000000000
111000000001111111
111000000001111111
111100000001111110
111100000000011110
111100000000000000
111000000000000000
100000000000000000
000000000000000000
000000000000000001
000000000000000011
000000000000000011
000000000000000111
000000110000000011
000001110000000011
111111110000000000
111111110000000000
111111110000000000
111111110000000000
111111000000000000
011000000000000000
000000000000000000
000000000000000000
000000000000000000
000000000100000000
000000001110000000
000000001110000000
000000001110000000
000000001110000000
000000001110000000
000000000000000000
100000000000000000
110000000000000000
111000000000000000
111000000001000000
111000000011110000
111000000011111000
110000000001111100
110000000001111111
000000000011111111
